....................
....................
....................
....................
....................
....................
....................
....................
....................
....................
....................
....................
....................
....................
....................
.......!............
.....YBYBY........|#
.................##D
.YY...BB..CC.####DDD
#############DDDDDDD
