....................
................!...
....................
....................
....................
....................
....................
....................
....................
....................
....................
....................
....................
....................
....................
....................
####....YYY.........
DDDD##..............
DDDDDDD##...........
DDDDDDDDD###########
