...................
...CC..BBB.#####...
...CC..BBB.#...#...
...CC..BBB.#...#...
...CC..BBB.#...#...
...CC..BBB.#...#...
...CC..BBB.#...#...
...CC..BBB.#...#...
...CC..BBB.#...#...
...CC..BBB.#...#...
...CC..BBB.#...#...
...CC..BBB.#...#...
...CC..BBB.#...#...
...CC..BBB.#...#...
...CC..BBB.#...#...
...CC..BBB.#...#...
...CC..BBB.#...#...
...CC......#####...
...................
...................

