####################
..............###...
....................
..#####.............
....................
...............###..
....................
....###.............
....................
..............###...
....................
..###...............
....................
..............###...
....................
....................
###.................
.........###........
....................
####################
