....................
....................
....................
....................
....................
....................
....................
....................
...!................
....................
....................
....................
....................
...............YBY..
.................C..
........C.....C.....
.......YYYY.YYYY....
.....YY.........YY..
....Y..CC.....CC..Y.
####D#############D#
