########################################
........................................
........................................
........................................
........................................
........................................
........................................
........................................
........................................
........................................
........................................
........................................
........................................
........................................
.....................C.....#####........
........................................
...................#####................
........!........###########............
.............#######################....
########################################
