####################
....................
....................
....................
....................
....................
....................
....................
....................
....................
....................
....................
....................
....................
....................
...................!
...................#
....BC#..........###
.............#######
####################
