####################
....................
....................
....................
....................
....................
....................
....................
....................
....................
....................
....................
....................
....................
....................
....................
...................#
....BC..!........###
.............#######
####################
