....................
....................
....................
....................
....................
....................
....................
....................
....................
.......###..........
....................
.............C......
....................
..........#.........
....................
..........#.........
..................#.
........###.....###.
....................
####################
