....................
....................
....................
....................
....................
....................
....................
....................
....................
....................
....................
....................
....................
....................
....................
...................!
...................#
..BCYYY###......Y##D
............B####DDD
#############DDDDDDD
