....................
....................
....................
....................
....................
....................
....................
....................
....................
....................
....................
....................
....................
....................
....................
.......!............
.....YBYBY..........
.............###....
...........##DDD##..
###########DDDDDDD##
