########################################
........................................
........................................
........................................
.......................#................
........................................
........................................
.....##.................................
........................................
.............................##.........
........................................
........................................
..............................#####.....
........................................
.....................C..................
..................#######...............
........................................
..####..................................
.............CCCCCCCCCCCCC..............
########################################
