....................
....................
....................
....................
....................
....................
....................
....................
....................
....................
....................
....................
....................
....................
....................
.......!............
.....YBYBY.........#
.................##D
.YY.......CC.####DDD
#############DDDDDDD
