####################
....................
....................
....................
....................
....................
....................
....................
....................
....................
....................
....................
....................
....................
.........###........
......###....###....
...###...........###
###.................
CCCCCCCCCCCCCCCCCCCC
####################