....................
....................
....................
....................
....................
....................
....................
....................
....................
....................
....................
........YYYY........
....................
....................
....................
.........!..........
.............YYY....
....######..........
..##DDDDDD##........
##DDDDDDDDDD########
