####################
....................
....................
....................
....................
....................
....................
....................
....................
....................
....................
....................
....................
....................
....................
....................
...................#
.................###
....CCCCC....#######
####################
