####################
....................
....................
....................
....................
....................
....................
....................
....................
....................
....................
....................
....................
......!.............
...#......#.........
....######..........
....................
....................
....................
####################