####################
....###............#
....................
....................
...###.........###..
..................##
....................
....................
....###.............
....................
...............###..
....................
.......###..........
....................
...###..............
.............###....
....................
###.................
....................
####################