....................
....................
....................
....................
....................
....................
....................
....................
....................
....................
....................
....................
....................
....................
....................
.........!..........
####....YYY.........
DDDD##..............
DDDDDDD##...........
DDDDDDDDD###########
