########################################
........................................
........................................
........................................
........................................
........................................
........................................
........................................
........................................
........................................
...................................#####
..............................####......
.....................########...........
....................####................
..................###...................
...............######...................
............#########...................
........#############...................
...##################...................
########################################