....................
....................
....................
....................
....................
....................
....................
....................
....................
....................
....................
....................
....................
....................
........CCCC........
.......YYYYYY.......
....................
....................
....................
####################
