....................
....................
....................
....................
....................
....................
....................
....................
....................
....................
....................
.......YYYYBYYYY....
.......Y............
....................
....................
....................
....................
....................
..................F.
####################
