....................
....................
....................
....................
....................
....................
....................
.............Y......
..............Y.....
....Y.Y.............
....Y.Y.......Y.....
....YY..............
...Y.Y........Y.....
...Y..Y.YYY.YY......
.......YYY.YYY......
........YY.YY.......
..Y....Y..YY........
...........Y........
.....YY.............
#Y..Y...............
