....................
....................
....................
....................
....................
....................
....................
....................
....................
....................
....................
....................
.........B..D...#..Y
.........B..D...#..Y
.........B..D..#...Y
.........B..D..#...Y
.........B..D..#...Y
.........B..D..#...Y
.........B.DD..#...Y
#........B.DD..#...Y
