....................
....................
....................
....................
....................
...........#####....
........########....
.......########.....
.......#########....
.......#########....
......#.#####..#....
.......#####...#....
........####...#....
........####...#....
........####...#....
........####...#....
..........######....
.............#......
....................
....................
