....................
....................
....................
....................
....................
....................
....................
.......#.#######....
..##############....
....############....
...####....######...
..##.###..########..
..##.....######.##..
..##.....########...
..###...#####.##....
..###########.......
.......##..##.......
.......#.###........
.........##.........
....................
