....................
....................
....................
....................
....................
....................
......CCCCC.CCC.....
..C.CC.........CC...
..C.............C...
..C.............C...
..C.................
..C.............C...
................C...
................C...
................CC..
.B..............B...
.BB.............B...
..B.............B...
..BBBBBBBBBBBBBBB...
....................
