....................
...............#....
......#####....#....
....#......#...#....
....#......#........
....##......#..#....
.....########..#....
.......#.###.###....
....................
....................
...BB.BBBBBBBBBBB...
....B............B..
....B............B..
....B............B..
....BBBBBBBBBBBBBB..
....................
....................
....................
....................
....................
