..##.#..#.#....#....
...#...####....#....
....###.###.........
.....##.##.###.#....
....#.########......
...#######.#.##.....
...############.....
...##.###......#....
...##.####.#.#...#..
...##.###...##....#
....######.#.#......
.....#####.###......
......########......
.....########.......
......#######.......
......##............
.......##...........
....................
....................
....................
