....................
....................
....................
....................
....................
....................
....................
....................
....................
....................
....................
....................
....................
....................
......BBBB..........
....................
....................
......#####.........
..CCCYYYYYY.........
YYYYYYYYYYYYYYYYYYYY
