....................
....................
....................
........###.........
......##..#####.....
.....##.......###...
.....#..#...#...#...
....#...#...#...#...
...##...#...#...#...
...#........#...#...
...#....#.......#...
....#...#....#..#...
.....#...#####..#...
......##.......#....
........##....##....
..........#####.....
....................
....................
....................
BBBBBBBBBBBBBBBBBBBB
