....................
....................
....................
............##.....C
...........#.#.....C
.............#.....C
........#....#.....C
....####...........B
...#.........#.....B
..#.#..............B
..............###..B
...#.......#.....#.B
...................B
.#...##.........#.BB
..##.....#..........
.##.................
.###...#.......#....
....##..............
............#.......
.....#.#.#..........
