....................
....................
....................
....................
.....#..............
.....#..............
.....#..............
.....#..............
.....#..............
.....#..............
.....#..............
....#...............
....#...............
....#...............
....#...............
....#...............
....#...............
....#############...
....................
....................
