####################
....................
..............###...
....................
....###.............
....................
.................###
....................
.....###............
....................
.........###........
....................
....................
....................
...............###..
....................
..###.........###...
....................
....................
####################