....................
....................
...............YYY..
....................
....................
....................
....................
....................
....................
....................
....................
....................
....................
....................
....................
.........CC.........
.........##.........
........#DD#........
.......#DDDD##...!..
#######DDDDDDD######
