########################################
........................................
........................................
.........#####..........................
..........................######........
........................................
........................................
........................................
............................#######.....
........................................
#######.................................
........#####...........................
..............#########.................
..######................................
........................................
..........................####..........
..................................#####.
........................................
........................................
########################################