....................
....................
....................
....................
....................
....................
....................
....................
....................
....................
....................
........YYYY........
....................
....................
....................
.........CC...!.....
.........##.........
........#DD#........
.......#DDDD#......#
#######DDDDDD######D
