....................
....................
....................
....................
....................
....................
....................
....................
....................
....................
....................
....................
....................
....................
.............YY...YY
............Y.......
...........YCC......
..........YYCC......
.........YYYCC....Y.
####################
