########################################
........................................
........................................
...............######...................
........................................
.............................###........
...........##B##........................
........................................
........................................
..................................#B#...
........#B#.............................
........................................
...................##B##B#..............
...............................#B#......
................##BB##..................
........................................
........#B#.............................
..####..................................
........................................
########################################
