####################
....................
....................
....................
....................
....................
....................
....................
........###.........
....................
....................
.......B.B.B........
....................
....................
....................
....................
...................#
.................###
.............#######
####################
