....................
....................
....................
....................
....................
....................
....................
....................
....................
....................
....................
....................
................!.C.
...............YYY..
.............##.....
............#DD.....
...........#DDD.....
..........#DDDD.....
.........#DDDDD.....
####################
