....................
....................
....................
....................
....................
....................
....................
....................
....................
....................
....................
........YYYY........
....................
....................
.............YY...YY
............Y.......
...........Y........
..........YYCC......
.........YYYCC....Y.
####################
