########################################
........................................
........................................
........................................
........................................
........................................
........................................
........................................
........................................
.............#############..............
........................................
........................................
........................................
........................................
........................................
........................................
........................................
........................................
........................................
########################################