....................
....................
....................
....................
....................
....................
....................
....................
....................
....................
....................
........YYYY........
....................
...............YBY..
.................C..
........C.....C.....
.......YYY...YYY....
.....YY.........YY..
....Y..CC..!..CC..Y.
####D#############D#
