########################################
........................................
........................................
...BBB.........................##........
....................##..................
........................................
.............####.......................
..............................###.......
........................................
...............................#####....
.................###....................
........................................
....................................####
........................................
....#.......#...........###.............
.....###B###............................
........................................
........................................
........................................
########################################