....................
....................
....................
....................
....................
....................
....................
....................
....................
....................
....................
........YYYY........
....................
....................
..................!.
.......CCC......YYYY
.....BYYYYYBYY.....Y
.............Y.....Y
.............Y.....Y
##############YYYYY#
