....................
....................
....................
....................
....................
....................
....................
....................
....................
..YYY...............
....................
....................
....................
....................
..................!.
.......CCC......YYYY
.....BYYYYYBYYYY....
..............YY....
.............YYY....
####################
