....................
....................
....................
....................
....................
....................
....................
....................
....................
....................
....................
....................
....................
....................
....................
YYYC.............BBB
DDDYYYC.............
DDDDDDYYYC.!........
DDDDDDDDDYYY........
####################
