########################################
........................................
........................................
........................................
........................................
........................................
........................................
........................................
........................................
........................................
........................................
........................................
........................................
...............#######..................
........................................
........................................
........................................
........................................
........................................
########################################