....................
....................
....................
....................
....................
....................
....................
....................
....................
....................
....................
........YYYY........
..................CC
.................YYY
.............#......
YBY........##D......
........###YCC......
.....###DDDYC.......
..###DDDDDDYC.!.....
####################
