....................
....................
....................
....................
....................
....................
.................CC.
.................###
...............##DDD
.............##DDDDD
.......######DDDDDDD
....###DDDDDDDDDDDDD
.###DDDDDDDDDDDDDDDD
#DDDDDDDDDDDDDDDDDDD
DDDDDDDDDDDDDDDDDDDD
DDDDDDDDDDDDDDDDDDDD
....................
....................
.......CCCCC........
####################
