####################
....................
....................
....................
....................
....................
....................
....................
........###.........
....................
....................
....................
....................
....................
....................
....................
..................B#
................B###
.............#######
####################
