########################################
........................................
........................................
........................................
........................................
........................................
........................................
........................................
........................................
........................................
........................................
......................#.................
........................................
........................................
........................................
........................................
........................................
........................................
........................................
########################################