....................
....................
....................
....................
....................
....................
.................CC.
................####
.............###DDDD
..........###DDDDDDD
.......###DDDDDDDDDD
....###DDDDDDDDDDDDD
.###DDDDDDDDDDDDDDDD
#DDDDDDDDDDDDDDDDDDD
DDDDDDDDDDDDDDDDDDDD
DDDDDDDDDDDDDDDDDDDD
....................
....................
.......CCCCC........
####################
