....................
....................
....................
....................
....................
....................
....................
Y...................
Y...................
Y...................
Y...................
Y.......YYYY........
Y...................
Y...................
Y...................
Y......!............
.....YBYBY........F.
.................###
......BB..CC.####DDD
#############DDDDDDD
