########################################
........................................
........................................
........................................
........................................
........................................
........................................
........................................
........................................
........................................
........................................
........................................
........................................
........................................
.....................C.....#####........
........................................
...................#####................
.................###########............
.....!.......#######################....
########################################
