########################################
........................................
........................................
........................................
........................................
........................................
........................................
........................................
........................................
..........###############...............
........................................
........................................
........................................
........................................
........................................
........................................
........................................
........................................
........................................
########################################