....................
....................
....................
....................
....................
....................
....................
....................
....................
....................
....................
..!.................
..................CC
.................###
..............###DDD
YBY........###DDDDDD
........###DDDDDDDDD
.....###DDDDDDDDDDDD
..###DDDDDDDDDDDDDDD
####################
