####################
..............###...
....................
..#####.............
....................
....!..........###..
....................
....###.............
....................
..............###...
...C................
..###...............
...............C....
..............###...
....................
.C..................
###.......C.........
.........###........
......CCCC..........
####################
